    	NO      XPM/1.xpm
		SO  	 	XPM/2.xpm
	 	 	 	XPM/3.xpm
	WE  	 	 XPM/4.xpm

F  	  0  , 0 , 0
C    200 , 220 , 0


1111111
1000011
11000W1
1100001
1111111