    	NO         XPM/1.xpm
		SO  	 	XPM/2.xpm
	EA 	 	 	XPM/3.xpm
	WE  	 	 XPM/4.xpm

F  	  0  , 0 , 0
C    200 , 220 , 255


1111111
1000011
1100$W1
1100001
1111111