
NO      XPM/1.xpm

		SO  	 	XPM/2.xpm
	EA 	 	 	XPM/3.xpm
	WE  	 	 XPM/4.xpm

F  	  0  , 0 , 0
C    120, 23 ,11

1111111
1000011
11000W1
1100001          1010010101
1111111





 
  
   






