    	NO         XPM/1.xpm
		SO  	 	XPM/2.xpm
	EA 	 	 	XPM/3.xpm
	WE  	 	 XPM/4.xpm

F  	  0  , 0 , 0
C    200 , 220 , 255


11111

111111111
11001
10W01
11111