    	NO         XPM/1.xpm
		SO  	 	XPM/2.xpm
	EA 	 	 	XPM/3.xpm
	WE  	 	 XPM/4.xpm

F  	  0  , 0 , 0
C    200 , 220 , 255


1111111

11101111
10000W1
1000001
1111111