    	NO         xpm/colorstone.xpm
		SO  	 	xpm/greystone.xpm
	EA 	 	 	xpm/purplestone.xpm
	WE  	 	 xpm/wood.xpm

F  	  122  , 0 , 50
C    0 , 0 , 255


1111111
1100001   
100W011
1100001
1111111