
NO      XPM/1.xpm
		SO  	 	XPM/2.xpm   
	EA 	 	 	XPM/3.xpm
	WE  	 	 XPM/4.xpm

F    0000000  , 0 , 0
C    00000122 , 23 ,11

1111111
1000011
1100001
110N001
1111111
