    	NO         ./textures/Chucky.xpm
		SO  	 	 	 ./textures/Scoobie.xpm
	EA 	 	 	./textures/Saw.xpm
	WE 	 	 	 ./textures/Scream.xpm

Fd 	  122  , 0 , 50
C    0 , 0 , 255


1111111     
100W001
1111111