    	NO         ./textures/Chucky.xpm
		SO 	 	 	 ./textures/Scoobie.xpm
	EA 	 	 	./textures/Saw.xpm
	WE 	 	 	 ./textures/Scream.xpm

F  	  0 , 0 , 50
C 	   0 , 0 , 255


1111111        
100W0 01
1111111