    	NO         XPM/pepe.xpm
		SO  	 	XPM/pepe.xpm
	EA 	 	 	XPM/pepe.xpm
	WE  	 	 XPM/pepe.xpm

F  	  0  , 0 , 0
C    200 , 220 , 255


1111111
100001
110W011
1100001
1111111