    	NO         ./textures/Chucky.xpm
		SO 	 	 	 ./textures/Scoobie.xpm
	EA 	 	 	./textures/Saw.xpm
	WE 	 	 	 ./textures/Scream.xpm

F  	  222 , 0 , 50
C 	   0 , 0 , d255


1111111        
100W001
1111111