
NO      XPM/1.xpm
		SO  	 	XPM/2.xpm
	EA 	 	 	XPM/3.xpm
	WE  	 	 XPM/4.xpm

F  	  0 2 , 0 , 0
C    12, 23 ,11

1111111
1000011
110N001
1100001
1111111





 
  
   






